6
0 1 4 1 4 1 
1 0 3 5 3 2 
4 3 0 1 1 1 
1 5 1 0 2 5 
4 3 1 2 0 4 
1 2 1 5 4 0 
